100000010100000000000010101111
000001000001000100001010000001
001000001010111010100110110000
000100000000001000000100000110
000000000000000000100000010000
100000000000010010001100000000
001000011000010010000010000000
001000000000010000000010001101
000000000000000000000100000000
100000100000000000000001000110
000011000000011000010000100000
000100010001001000001000000000
100100000000101010000010000000
100000100010000000010001000001
010100001001001001001000000010
000000001010000000010000001100
000000001000000000001001001000
000010010000000000000000000000
010001000001000000000001000000
000000001000000000000000010000